WWWW---WWW
---W------
--WWWWWW-W
-------O--
WWWWWWWWW-
----------
-WW-WW-WW-
----------
WW-WW-WW-W
X---------